
NO ./textures/north.png
SO ./textures/south.png
WE ./textures/west.png
EA ./textures/east.png
F    75,53,38
C    183,188,204   






1111111111111111111 
1010000000000001001
1000011111011101001
1E00011111011101001
1111100000000000001
11111111111111111111