
NO ./textures/north.png
SO ./textures/south.png
WE ./textures/west.png
EA ./textures/east.png
F   212,100,0
C   226,30,1


1111111  
101000011
10000111 
1E00011
111111111
