
NO ./textures/north.png
SO ./textures/south.png
WE ./textures/west.png
EA ./textures/east.png
F   212,100,0
C   226,30,0



111111
101000111
10000111
1E00011
1111111111
