
NO ./textures/822.png
SO ./textures/884.png
WE ./textures/885.png
EA ./textures/822.png
F   220,100,0
C   225,30,0



111111
101000111
10000111
1E00011
1111111111
