NO ./textures/822.png
SO ./textures/884.png
WE ./textures/885.png
EA ./textures/822.png

F    75,53,38
C    183,188,204       


1111111111
111S000001
1111111111
1111111111