NO ./textures/north.png
SO ./textures/south.png
EA ./textures/east.png
WE ./textures/west.png


F    111,0,0
C    113,188,204

111111111111
100000000001
100000000001
100000000N01
111111111111
